##########
#        #
#        #
#        #
#        #
#    P   #
#        #
#        #
#        #
##########